Acer negundo - klon jesionolisty
Ailanthus altissima - bożodrzew gruczołowaty
Alternanthera philoxeroides
Ambrosia artemisiifolia - ambrozja bylicolistna
Amelanchier spicata - świdośliwa kłosowa
Asclepias syriaca - trojeść amerykańska
Aster novi-belgii - aster nowobelgijski
Azolla filiculoides - azolla drobna
Baccharis halimifolia - komarnik wirginijski
Bidens frondosa - uczep amerykański
Bromus carinatus - stokłosa spłaszczona
Cabomba caroliniana - kabomba karolińska
Celastrus orbiculatus - dławisz okrągłolistny
Clematis vitalba - powojnik pnący
Cornus sericea - dereń rozłogowy
Crassula helmsii - grubosz Helmsa
Echinocystis lobata - kolczurka klapowana
Eichhornia crassipes - eichornia gruboogonkowa
Elodea canadensis - moczarka kanadyjska
Elodea nuttallii - moczarka delikatna
Eragrostis albensis - miłka połabska
Fraxinus pennsylvanica - jesion pensylwański
Gunnera tinctoria - gunera chilijska
Helianthus tuberosus - słonecznik bulwiasty
Heracleum mantegazzianum - barszcz Mantegazziego
Heracleum persicum - barszcz perski
Heracleum sosnowskyi - barszcz Sosnowskiego
Hydrocotyle ranunculoides - wąkrota jaskrowata
Impatiens capensis - niecierpek pomarańczowy
Impatiens glandulifera - niecierpek gruczołowaty
Impatiens parviflora - niecierpek drobnokwiatowy
Lagarosiphon major - lagarosyfon wielki
Ludwigia grandiflora
Ludwigia peploides
Lupinus polyphyllus - łubin trwały
Lysichiton americanus - tulejnik amerykański
Microstegium vimineum
Mimulus guttatus - kroplik żółty
Myriophyllum aquaticum - wywłócznik brazylijski
Myriophyllum heterophyllum - wywłócznik różnolistny
Padus serotina - czeremcha amerykańska
Parthenium hysterophorus - partenium ambrozjowate
Parthenocissus inserta - Winobluszcz zaroślowy
Pennisetum setaceum - rozplenica szczecinkowata
Persicaria perfoliata
Pueraria montana - opornik łatkowaty
Quercus rubra - dąb czerwony
Reynoutria japonica - rdestowiec japoński
Reynoutria sachalinensis - rdestowiec sachaliński
Reynoutria x bohemica - rdestowiec czeski
Robinia pseudoacacia - robinia akacjowa
Rosa rugosa - róża pomarszczona
Rudbeckia laciniata - rudbekia naga
Solidago candensis - nawłoć kanadyjska
Solidago gigantea - nawłoć późna
Solidago graminifolia - nawłoć wąskolistna
Spartina anglica - spartyna angielska
Spiraea tomentosa - tawuła kutnerowata
Ulex europaeus - kolcolist zachodni
